99999999999999999900
99699999999999900099
99999999999900099999
99999999900099999699
99999999000999999999
99999999900099999999
99999999990009999999
99999996999999000099
99999993399999990000
99993333000022229000
99999999111119999999
99999999999999999699
99999999999999999000
99994444444449999999
99999999999999999999
99999999999999999999
99999999999999999999
99999999000099999999
99999999077099999999
99599999077099999999
