99999999999999999900
99999999992299222099
99969999999900099999
99999999900099999999
99999944444444999999
99999999900099999999
99999933333333900099
99999993399999990000
99993333000022229000
99999999111119999999
99999999999999999999
99999999999999999000
99994444444449999999
99999999999999999999
99999999999999999999
99999999999999999999
99999999999999999999
99999999000099999999
99999999077099999999
99599999077099999999
